Year,Murder,Rape,Robbery,Assault,Burglary,Larceny,Auto Theft,Total
2010,22,54,716,767,2099,7637,334,11629
2011,22,57,603,712,2144,6931,332,10801
2012,29,74,471,669,1814,6339,292,9688
2013,8,38,521,657,1731,6190,230,9375
2014,18,55,489,502,1650,6280,206,9200
2015,20,57,515,547,1444,6090,226,8899
2016,21,65,399,499,1337,5294,255,7870
2017,21,54,345,428,1230,5460,278,7816
2018,16,46,231,391,865,4657,196,6402
2019,13,49,272,338,857,5174,283,6986
2020,7,38,98,255,478,2280,158,3314
